12 20
####################
#3    B*####*B   3 #
#      **##**      #
#**#####****#####**#
#                  #
#  # *S  ##  ** #  #
#  # **  ##  ** #  #
# *#p    ##    1#F #
#**####**##**####**#
#  *     **     *  #
#1 *F 2  X*   2 *1 #
####################