12 20
###################
#p     ** *    *3 #
# # # #*# # #*#*# #
#   *     ***  *  #
# # # # # #*# # #*#
#            **  *#
# # # # # # # # # #
#*  *      *  *   #
# # # # #*# # # #*#
#*    **  *       #
# #*# # # # # # #*#
###################