12 20
####################
##** 1 **##** 1 **##
#**     *FF*     **#
#*  ##   **   ##  *#
#  #  #      #  #  #
# #  2 * p  *2   # #
# #2   *    *   2# #
#  #  #      #  #  #
#*  ##   **   ##  *#
#**     *XB*     **#
##** 1 **##** 1 **##
####################