12 20
####################
#*3     *  *     3B#
# *   ###  ###   * #
#  #    #  #    #  #
#   F   #  #   *   #
#    ##  p   ##    #
#    ##      ##    #
#   *   #  #   B   #
#  #    #  #    #  #
# S   ###  ###   * #
#*3     X  *     3*#
####################