12 20
####################
#p#      *       1*#
# # ### # ##########
# # #*# # #        #
# # # # # *# ###***#
#*# #1# ## #  *#1 1#
#B#* *# *# # ###   #
#F# #### #2# * #***#
#S#    # #*# ###   #
# #### # ###  *#2 2#
#     *#     ###***#
####################