12 20
###################
#p     ** *    *2 #
# # # #*# # #*#*# #
#   *     ***  *  #
# #b# # # #*#*# #*#
#           1**  *#
# # # # # # # # # #
#*  *      *  *   #
# # # # #*# # # #*#
#*    **1 *       #
# #*# # # # # # #*#
###################

