12 20
####################
#p#  *   ***     1B#
# # ### # ##########
# # #F# # #*     1 #
# # #1# # *# ###***#
#*# # # ## #  S#   #
# #* *# *# # ###1 1#
# # #### #2# *F#***#
# #    # #*# ###   #
# #### # ###  B#2 2#
#     *#     ###*X*#
####################