12 20
####################
#p     ** *    *3  #
# # # #*# # #*#*#  #
#b  *b    ***  *   #
# # # # # #*# # #* #
#  b         **  * #
# # # # # # # # #  #
#*  *      *  *    #
# # # # #*# # # #* #
#*    **  *        #
# #*# # # # # # #* #
####################