12 20
####################
#1   #1  ##  1#   1#
# ## # # ## # # ## #
#   *#   ##   #*   #
#  ******##******  #
#### *   Xp   * ####
#### *    *   * ####
#  ******##******  #
#   *#   ##   #*   #
# ## # # ## # # ## #
#1   #1  ##  1#   1#
####################