12 20
####################
#p #*  # B #  *#  2#
##  *#   #   # **# #
#* #*  # 1 #   #***#
##** #  *#** # * #*#
#  #   # 1 #** #  F#
##2*F# **#*X*# * # #
#  #  *# 1 #*  #  2#
##** #  *#** # * # #
#* #*  # 1 #  *#***#
##2 *# B # * #  *#S#
####################