12 20
####################
#1    *      *    2#
#    1*      *     #
#*#  #  #**#  #  #B#
# #X #  #  #  # S# #
# ####  #p #  #### #
# #  #  ####  #  # #
# #  #  #3B#  #  # #
#F#**#* #  # *#**#*#
#      *    *1     #
#2     *    *     1#
####################