12 20
###################
#        p        #
###################
#                 #
# # # # # # # # # #
#                 #
# # # # # # # # # #
#                 #
# # # # # # # # # #
#                 #
# # # # # # # # # #
###################



###################
#b              p #
# # # # # # # # # #
#                 #
# # # # # # # # # #
#                 #
# # # # # # # # # #
#                 #
# # # # # # # # # #
#                 #
# # # # # # # # # #
###################