12 20
###################
#    b            #
# # # # # # # # # #
#                 #
# # # # # # # # # #
#    p            #
# # # # # # # # # #
#                 #
# # # # # # # # # #
#                 #
# # # # # # # # # #
###################